1111111111111111111
100110010000C00C0C1
1000C00C00C00C00001
1P111CCC000100000C1
1E11100C00000C00001
1111111111111111111